type octile
height 4
width 8
map
TTT...TT
T......s
T.@.@@.T
..@..eTT
