type octile
height 4
width 8
map
TTT...TT
T.......
T.@.@@.T
..@...TT
