type octile
height 8
width 13
map
@@@@@@@@@@@@@@TTTTTTTTTT@@@@@@@@@@@@@@@@@@@@@@@@@@@@@@@@@@@@@@@@@@@@@@@@@@@@@@@@@TT@@T..T@@TT@@@@@@@@@@@@@@@@@@@@@@@@
@@@@@@@@@T@@@T.........sT@@@@@@@@@@@@@@@@@@@@@@@@@@@@@@@@@@@@@@@@@@@@@@@@@@@@T@@T..T@T..T@T..T@@@@@@@@@@@@@@@@@@@@@@@
@T..TTT...T@@T.......TTT@@@@@@@@@@@@@@@@@@@@@@@@@@@@@@@@@@@@@@@@@@@@@@@@@@@@@T@@T..TTT..TTT..T@@@@@@@@@@@@@@@@@@@@@@@
TT........TTTT.......T@@@@@@@@@@@@@@@@@@@@@@@@@@@@@@@@@@@@@@@@@@@@@@@@@@@@@@TTTTT............TTTT@@@@@@@@@@@@@@@@@@@@
.....................T@@@@@@@@@@@@@@@@@@@@@@@@@@@@@@@@@@@@@@@@@@@@@@@@@@@@@T.....................T@@@@@@@@@@@@@@@@@@@
.....................T@@@@@@@@@@@@@@@@@@@@@@@@@@@@@@@@@@@@@@@@@@@@@@@@@@@@@@T....................T@@@@@@@@@@@@@@@@@@@
.....................T@@@@@@@@@@@@@@@@@@@@@@@@@@@@@@@@@@@@@@@@@@@@@@@@@@@@@T......................T@@@@@@@@@@@@@@@@@@
.....................T@@@@@@@@@@@@@@@@@@@@@@@@@@@@@@@@@@@@@@@@@@@@@@@@@@@@T........................T@@@@@@@@@@@@@@@@@
.....................T@@@@@@@@@@@@@@@@@@@@@@@@@@@@@@@@@@@@@@@@@@@@@@@@@@@T..........................T@@@@@@@@@@@@@@@@
.....................T@@@@@@@@@@@@@@@@@@@@@@@@@@@@@@@@@@@@@@@@@T@@@@@@@@T............................T@@@@@@@@@@@@@@@
.....................T@@@@@@@@@@@@@@@@@@@@@@@@@@@@@@@@@@@@@@@@T.T@@@@@@T..............................T@@@@@@@@@@@@@@
.....................T@@@@@@@@@@@@@@@@@@@@@@@@@@@@@@@@@@@@@@@@T..T@@@@T................................T@@@@@@@@@@@@@
.....................T@@@@@@@@@@@@@@@@@@@@@@@@@@@@@@@@@@@@@@@@T...T@@T..................................T@@@@@@@@@@@@
.....................T@@@@@@@@@@@@@@@@@@@@@@@@@@@@@@@@@@@@@@@@T....TT....................................TT@@@@@@@@@@
TT........TTTT.......TTT@@@@@@@@@@@@@@@@@@@@@@@@@@@@@@@@@@@@@@@TTT.........................................T@@@@@@@@@
@T........T@@T..........T@@@@@@@@@@@@@@@@@@@@@@@@@@@@@@@@@@@@@@@@T.........................................T@@@@@@@@@
@T........T@@T..........T@@@@@@@T@@@TTTTTT@@@@TTTTTT@@@@@@@@@@@@@T.........................................T@@@@@@@@@
TT........TTTT..........TTT@@TTT.T@T......T@@T......T@@@@@@@@@@@TT.........................................TTT@@@@@@@
...........................TT....T@T......T@@T......T@@@@@@@@@@T..............................................T@@@@@@
...........................TT....TTT......TTTT...TTT@@@@@@@@@@@T..............................................T@@@@@@
.........................TT@@TT..................TTTTTTTTT@@@@@@T.............................................T@@@@@@
.........................T@@@@T...........................T@@@@@T.............................................T@@@@@@
.........................TTTTTT............................TTTTTT.............................................T@@@@@@
..............................................................................................................T@@@@@@
..............................................................................................................T@@@@@@
.........................TTTTTT............................TTTTTT.............................................T@@@@@@
.........................T@@@@T...........................T@@@@@T.............................................T@@@@@@
.........................T@@@@T..................TTTTTTTTT@@@@@TT.............................................T@@@@@@
..........................T@@T...TTT......TTTT...TTT@@@@@@@@@@T...............................................T@@@@@@
..........................T@@T...T@T......T@@T......T@@@@@@@@@T...............................................T@@@@@@
TT........TTTT..........TT@@@T...T@T......T@@T......T@@@@@@@@@@TTT............TTT..........................TTT@@@@@@@
@T........T@@T..........T@@@@@TTT@@@TTTTTT@@@@TTTTTT@@@@@@@@@@@@@T............T@@@.........................T@@@@@@@@@
@T........T@@T..........T@@@@@@@@@@@@@@@@@@@@@@@@@@@@@@@@@@@@@@@@T...........T@@@@@T.......................T@@@@@@@@@
TT........TTTT.......TTT@@@@@@@@@@@@@@@@@@@@@@@@@@@@@@@@@@@@@@@TTT...........@@@@@@@.......................TTT@@@@@@@
.....................T@@@@@@@@@@@@@@@@@@@@@@@@@@@@@@@@@@@@@@@@T..............@@@@@@@..........................T@@@@@@
.....................T@@@@@@@@@@@@@@@@@@@@@@@@@@@@@@@@@@@@@@@@T..............@@@@@@@..........................T@@@@@@
.....................T@@@@@@@@@@@@@@@@@@@@@@@@@@@@@@@@@@@@@@@@T..............T@@@@@T........................TT@@@@@TT
.....................T@@@@@@@@@@@@@@@@@@@@@@@@@@@@@@@@@@@@@@@@T..............TT@@@TT........................T@@@@@T..
.....................T@@@@@@@@@@@@@@@@@@@@@@@@@@@@@@@@@@@@@@@@T.............................................TTTTTT...
.....................T@@@@@@@@@@@@@@@@@@@@@@@@@@@@@@@@@@@@@@@@T......................................................
.....................T@@@@@@@@@@@@@@@@@@@@@@@@@@@@@@@@@@@@@@@@T......................................................
.....................T@@@@@@@@@@@@@@@@@@@@@@@@@@@@@@@@@@@@@@@@T.............................................TTTTTT...
.....................T@@@@@@@@@@@@@@@@@@@@@@@@@@@@@@@@@@@@@@@@T.............................................T@@@@@Te.
.....................T@@@@@@@@@@@@@@@@@@@@@@@@@@@@@@@@@@@@@@@@T.............................................T@@@@@@TT
TT........TTTT.......T@@@@@@@@@@@@@@@@@@@@@@@@@@@@@@@@@@@@@@@@T..............................................T@@@@@@@
@T..TTT...T@@T.......TTT@@@@@@@@@@@@@@@@@@@@@@@@@@@@@@@@@@@@@@T..............................................T@@@@@@@
@@TT@@T...T@@T..........T@@@@@@@@@@@@@@@@@@@@@@@@@@@@@@@@@@@@@@TTT.........................................TT@@@@@@@@
@@@@@@T..T@@@@TTTTTTTTTT@@@@@@@@@@@@@@@@@@@@@@@@@@@@@@@@@@@@@@@@@T.........................................T@@@@@@@@@
@@@@@@T..T@@@@@@@@@@@@@@@@@@@@@@@@@@@@@@@@@@@@@@@@@@@@@@@@@@@@@@@T.........................................T@@@@@@@@@
@TTT@@T...T@@@@@@@@@@@@@@@@@@@@@@@@@@@@@@@@@@@@@@@@@@@@@@@@@@@@TTT.........................................T@@@@@@@@@
T..........T@@@@@@@@@@@@@@@@@@@@@@@@@@@@@@@@@@@@@@@@@@@@@@@@@@@@@@@@@@@@@@@@T....................T@@@@@@@@@@@@@@@@@@@
T..........T@@@@@@@@@@@@@@@@@@@@@@@@@@@@@@@@@@@@@@@@@@@@@@@@@@@@@@@@@@@@@@@@@TTTT............TTTT@@@@@@@@@@@@@@@@@@@@
T..........T@@@@@@@@@@@@@@@@@@@@@@@@@@@@@@@@@@@@@@@@@@@@@@@@@@@@@@@@@@@@@@@@@T@@T............T@@@@@@@@@@@@@@@@@@@@@@@
@TTT.....TT@@@@@@@@@@@@@@@@@@@@@@@@@@@@@@@@@@@@@@@@@@@@@@@@@@@@@@@@@@@@@@@@@@T@@T............T@@@@@@@@@@@@@@@@@@@@@@@
@@@T.....@@@@@@@@@@@@@@@@@@@@@@@@@@@@@@@@@@@@@@@@@@@@@@@@@@@@@@@@@@@@@@@@@@@@@@@@TTTTTTTTTTTT@@@@@@@@@@@@@@@@@@@@@@@@
@@@T.....@@@@@@@@@@@@@@@@@@@@@@@@@@@@@@@@@@@@@@@@@@@@@@@@@@@@@@@@@@@@@@@@@@@@@@@@@@@@@@@@@@@@@@@@@@@@@@@@@@@@@@@@@@@@
