type octile
height 8
width 13
map
TTTTTTTTe.TTT
T......@.....
T..@@..@@@...
....@.......T
T............
T@@...@@@@@..
.s@.........T
.....TTTTTTTT
